1111111111111
1P000001000E1
100X0C0000011
10000000C0001
1001111000001
1001000001000
1101000C01000
1111111111111