1111111111111
1P00000100011
100X0C0000011
10000000C0001
1001111000001
1001000001001
1101000C01001
1111111111111