1111111111111
1P000001000E1
10000C0000011
10000000C0001
1001111000001
1001000001001
1101000C01111
111111111