1111111111111
1P100001001E1
10000C0000011
10000000C0001
1001001000001
1001000001001
1101000C00001
1111111111111