1111111111111
1P000001100E1
10000C0000011
10000000C0001
1001111000001
1001000001001
11C1000C010C1
1111111111111
